#################F##
#             #    #
#             #    #
#             #    #
#    ##########    #
#    #             #
#    #             #
#                  #
#                  #
#S##################