###################################F#
#                          ######## #
#                           #       #
#              ###########  #### ####
#              ###########  #### ####
#              ##           ####    #
#  ##############           #### ## #
#              ##   ############ ## #
#############  ##   ############ ## #
#       #      ##             ## ## #
#       #      ##   ######### ## ## #
#       #      ##   ###       ## ## #
#       #      ##   ############ ## #
#              ##                ## #
#S###################################
