####################
#             #    #
#             #    #
#             #    #
#    ##########    #
#    #     #       #
#    #     #       #
#    #             #
#                  #
#S######F###########