######################E###
#######                ###
#######    ##  ###########
#######  #####  ##########
#######                 ##
##      ############### ##
## #### ######     #### ##
## #### ###### ### #### ##
## #### ###### ### #### ##
##             ###      ##
##S#######################
